*******
*---A-*
<-----*
*-----*
*---O-*
*-----*
****V**