*******
*A----*
*----->
*-----*
*---O-*
*-----*
***V***