*******
*-----*
*----->
*-----*
*--P--*
*-----*
***V***