*******
*A----*
*----->
*--W--*
*-----*
*---P-*
***V***