*******
*A----*
*----->
*--W--*
*-----*
*--P--*
***V***