*******
*A----*
*----->
*--W--*
*--P--*
*-----*
***V***