*******
*A----*
*----->
*-----*
*--P--*
*-----*
***V***