*******
*A----*
*----->
*--W--*
*-----*
*-----*
***V***