*******
*A----*
*---W->
*-----*
*-----*
*-----*
***V***