***^***
*A----*
*-----*
*----->
*-----*
*-----*
*******