***^***
*A----*
*-----*
*----->
*--W--*
*-----*
*******