*******
*A----*
*-----*
*-----*
*---W-*
*-----*
***V***