****^**
*A----*
*-----*
<-----*
*---W-*
*-----*
*******